--------------内联元素(inline element)和块级元素(block element)----------------
块级元素：div  , p  , form,   ul,  li ,  ol, dl,    form,   address,  fieldset,  hr, menu,  table
行内元素：span,   strong,   em,  br,  img ,  input,  label,  select,  textarea,  cite,  

常见块元素(block element)
address     地址
blockquote  块引用
center      居中对齐块
dir         目录列表
div			常用块级容器，也是css layout的主要标签
dl 			定义列表
fieldset		form控制组
form			交互表单
h1-h6 		标题
hr 			水平分隔线
isindex 		input prompt
menu			菜单列表
noframes 	frames可选内容，（对于不支持frame的浏览器显示此区块内容）
noscript 	可选脚本内容（对于不支持script的浏览器显示此内容）
ol			排序表单
p 			段落
pre			格式化文本
table		表格
ul			无序列表 

常见内联元素(inline element)
a 			锚点
abbr			缩写
acronym		首字
b 			粗体(不推荐)
bdo 			bidi override
big 			大字体
br 			换行
cite 		引用
code 		计算机代码(在引用源码的时候需要)
dfn			定义字段
em			强调
font			字体设定(不推荐)
i			斜体
img 			图片
input		输入框
kbd 			定义键盘文本
label 		表格标签
q 			短引用
s			中划线(不推荐)
samp			定义范例计算机代码
select 		项目选择
small 		小字体文本
span 		常用内联容器，定义文本内区块
strike		中划线
strong 	    粗体强调
sub   		下标
sup   		上标
textarea		多行文本输入框
tt    		电传文本
u     		下划线
var  		定义变量

可变元素：由上下文语境来决定是块元素还是内联元素
applet 		java applet
button 		按钮
del    		删除文本
iframe 		inline frame
ins    		插入的文本
map    		图片区块（map）
object 		object对象
script 		客户端脚本




address  blockquote  center  dir  div	 dl  fieldset	 form	 h1-h6 	 hr  
isindex 	 menu	 noframes 	 noscript 	 ol	 p 	 pre		 table	 ul		 

a  abbr	 acronym		 b 	 bdo  big  br  cite 	 code  dfn	 em		
font		 i	 img  input	 kbd  label  q 	 s	 samp	 select 	 small 	 span 	 strike	
strong 	 sub   	 sup   textarea		 tt    	 u      var  	

可变元素：由上下文语境来决定是块元素还是内联元素
applet|button|del|iframe|inline|frame|ins|map|object|script 		

















